R 900 500





NO ./textures/wood.xpm
SO ./textures/redbrick.xpm
WE ./textures/stone.xpm
EA ./textures/mossy.xpm
S ./textures/hitler.xpm
F 220,000,700


11111111111111111111111111111111
10000000010000011000000000000001
10010001000000000000000000W00001
10010011111111111111111111111111
10010000000000011000000000000001
11110000000000000000000000020001
10010000111111111111100000000001
10010000000000000000000000000001
10011111111111110011111111111111
10000000000000011000010000000001
10000000000000011000010000000001
10000011110000000000000000000001
10000000001000011000000000000001
10000100001000011000010000000001
10000011110000011000010000000001
10000000000000011000010000002001
10000000000000011020010000000001
11111111111111111111111111111111