11111111111111111111111111111111
10000000000000011000000000000001
10000000000000000000000000000001
10000000000000011000000000000001
10000000100000011000000000000001
10000001010000011000000000000001
10000000000000011000000000000001
10000000000000011000000000000001
10000000000000000000000000000001
10000000N00000011000000000000001
10000000000000011000000000000001
10000000000000000000000000000001
10000000000000011000000000000001
10000000000000011000000000000001
10000000000000011000000000000001
10000000000000011000000000000001
10000000000000011000000000000001
11111111111111111111111111111111