R 1200 500

NO ./textures/wood.xpm
SO ./textures/redbrick.xpm
WE ./textures/stone.xpm
EA ./textures/mossy.xpm

S ./textures/hitler.xpm

11111111111111111111111111111111
10000001010000011000000000000001
100100010000000000000000W0000001
10010011111111111000000000000011
10010000000000011000000000000001
11110001111111111111000000000001
10010000000000000000000000000001
10010000002000000000000000000001
11111111111111110011111000111111
10000000000000011000010000000001
10000000000000011000010000000001
10000011110000000000000000000001
10000100000000011000000000000001
10000100200000011000010000000001
10000011110000011000010000000001
10000000000000011000010000002001
10000000000000011020010000000001
11111111111111111111111111111111