
11111111111111111111111111111111
10000000000000011000000000000001
10000000000000000000000000000001
10000000000000011000000000000001
10000000000000011000000000000001
10000000000000000000000000000001
10000000000000W00000000000000001
10000000000000000000000000000001
10000000000000000000000000000001
10000000000000011000000000000001
10000000000000011000000000000001
10000011110000000000000000000001
10000000001000011000000000000001
10000100001000011000000000000001
10000011110000011000000000000001
10000000000000011000000000002001
10000000000000011000000000000001
11111111111111111111111111111111