11111111111111111111111111111111
10000000000000011000000000000001
10000000000000000000000000000001
10000000000000011000000000000001
10000000100000011000000000000001
10000001010000011000000000000001
10000000000000011000000000000001
10000000000000022000000000000002
20000000000000000000000000000002
20000000N00000022000000000000002
20000000000000022000000000000002
20000033330000000000000000000002
20000000000000022000000000000002
20000000000000022000000000000002
20000000000000022000000000000002
10000000000000011000000000000001
10000000000000011000000000000001
11111111111111111111111111111111